MAZE 8 16
  1  11   1  12
  0  14   1  14
  6   3   6   4
  2   6   3   6
  0  10   1  10
  3   9   3  10
  4   1   4   2
  0   1   1   1
  2  11   3  11
  2   0   3   0
  0   3   1   3
  2  10   2  11
  3   7   4   7
  2   8   3   8
  7   9   7  10
  3   2   3   3
  6   6   6   7
  1  12   1  13
  2   6   2   7
  5   9   6   9
  6   0   7   0
  7   6   7   7
  2   3   2   4
  6  12   7  12
  6   2   7   2
  3   8   4   8
  4   6   4   7
  0   7   1   7
  1   4   2   4
  1  13   2  13
  1   3   2   3
  4  14   4  15
  5   4   6   4
  3   5   3   6
  5   6   6   6
  2   8   2   9
  1   3   1   4
  2  12   3  12
  5   2   5   3
  4  12   5  12
  0   6   1   6
  5   7   6   7
  5   5   5   6
  6  13   7  13
  0   4   0   5
  4   9   4  10
  3   3   3   4
  1   0   2   0
  4  13   5  13
  4   7   5   7
  3  14   4  14
  6   7   7   7
  6   1   6   2
  3   5   4   5
  2   5   3   5
  5   9   5  10
  5   1   6   1
  5   4   5   5
  1   5   1   6
  1   6   2   6
  6  10   6  11
  3  11   3  12
  2  11   2  12
  0   7   0   8
  2  13   3  13
  1  15   2  15
  6  11   6  12
  5  10   6  10
  3  12   3  13
  1   9   1  10
  6  15   7  15
  3   1   3   2
  1   7   1   8
  0   9   1   9
  3   6   3   7
  5  14   5  15
  2   1   2   2
  3  10   4  10
  0   4   1   4
  4   2   4   3
  4  14   5  14
  5  13   5  14
  7  12   7  13
  5   3   6   3
  4  11   5  11
  7   1   7   2
  6   4   6   5
  1   1   1   2
  4   0   4   1
  6   8   6   9
  5  11   6  11
  2   7   2   8
  3   2   4   2
  0  13   1  13
  1  10   2  10
  4  15   5  15
  3   1   4   1
  4   8   5   8
  0   8   1   8
  5   3   5   4
  1  14   1  15
  6  12   6  13
  2  15   3  15
  7   4   7   5
  6   5   6   6
