MAZE 4 7
  0   2   1   2
  2   1   3   1
  3   0   3   1
  1   5   1   6
  0   4   0   5
  1   0   1   1
  2   3   3   3
  2   6   3   6
  1   1   1   2
  0   3   0   4
  0   5   0   6
  0   1   1   1
  2   4   3   4
  2   3   2   4
  1   4   1   5
  0   3   1   3
  3   4   3   5
  2   2   2   3
